1111111111111
1P000C0C00001
1011111111101
10C00E0000101
1011101110101
1000000C10101
1011111111001
100000000C001
1111111111111