111111111111111111111111111111
1P0000C00001111111100000C00001
101111111101000000001111111101
1010000C1000000E00000C0000C101
101011111001111111100111111101
10100000C0C00C000000000000C001
101111111001111111100111111101
1010C000001000000000C0000C1011
101111111101000000001111111101
1C0000000001111111100000000C01
100C0C000C0000000000C000C00001
111111111111111111111111111111