11111111111111111111
10000000C00000000001
10000C00000C00000001
1000000111100000C001
10C00001E01000000001
1000000101100C000001
100C0001001000000001
1000C00000000001C001
10P00000C0000C000001
11111111111111111111