111111111111
1P0000C00001
101111111101
1C1000000101
101011E00101
101000010101
1C00C1000C01
111111111111