111111111111111111
1P0000C000C0000001
111111111110110101
100000000C0000C101
101111111111111101
1C1000000000000001
101011111110111101
101010000C00000101
101010111110110101
101010100000010101
101010101110010101
101010101E00010101
101010101100010101
1010101C1000010101
101C00100000C10101
1011111111111110C1
10C000000000000001
111111111111111111