11111111
10000001
1C0P0C01
100E0001
1C00C001
10000C01
10C00001
11111111