111111111111111
100000C00C00001
1P0101010101101
1E0C01C000C0001
111111111111111